R        1920     880
SO textures/mc_bg.xpm
NO textures/mc_bg.xpm
WE textures/mc_bg.xpm
EA textures/mc_bg.xpm
S textures/sprite.xpm
C 85,     85,        85
F 51,    102,    100


111111111111
102020102011
1000N0000111
111111111111
111111111111
1111111


