R 640 480

NO ./path_to_the_north_texture
SO ./path_to_the_south_texture
WE ./path_to_the_west_texture
EA ./path_to_the_east_texture
S ./path_to_the_sprite_texture

11111111
F 220,100,225
C 225,30,225

10011011
10010001
11111101
    1101
11111001
11111111


