R 1000 600

NO ./path_to_the_north_texture
SO ./path_to_the_south_texture
WE ./path_to_the_west_texture
EA ./path_to_the_east_texture
S ./path_to_the_sprite_texture

F 220,100,225
C 225,30,225

11111111111111111110
10011001000000000011
10N10001000000000001
10000001000111100001
10000001000100000001
10000000000100000001
1111111111111111111
