R 1000 600

NO ./path_to_the_north_texture
SO ./path_to_the_south_texture
WE ./path_to_the_west_texture
EA ./path_to_the_east_texture
S ./path_to_the_sprite_texture

F 220,100,225
C 225,30,225

1111111111111111111111111
1000000000110000000000001
101100S001110000002000001
1001000000000000000000001
111111111011000001110000111111111
100000000011000001110111111111111
1111011111111101110000001000000001
1111011111111101110101001000000001
1100000011010101110000000000000001
1000200000000000110000001000000001
10000000000000001101010010000000011
11000001111111111111011110000000011
11110111               101111010001
11111111               111111111111
