R 800 440

NO ./path_to_the_north_texture
SO ./path_to_the_south_texture
WE ./path_to_the_west_texture
EA ./path_to_the_east_texture
S ./path_to_the_sprite_texture

F 220,100,225
C 225,30,225

11111111
10011011
10010001
10000001
100N0001
10000001
11111111


