R 640 480
NO ./cowboy.xpm
SO ./django_unchaned.xpm
WE ./james_din.xpm
EA ./marilyn-monroe.xpm
S ./barrel.xpm

F 255, 140, 0
C 128,128,0

111111111111
1000L0100011
1000N2200111
111111111111

