R  2000     2000

SO textures/mc_bg.xpm
NO textures/mc_bg.xpm
WE textures/mc_bg.xpm
EA textures/mc_bg.xpm
S textures/sprite.xpm
C  204, 255, 255
F  51,    102,    0


1111111111111111111111111
1000202000110000002222001
1011000001110E00002222001
1001000000000000002222001
111111111011000001110000111111111
100000000011000001110111111111111
1111011111111101110000001000000001
1111011111111101110101001000000001
1100000011010101110000000000000001
1000200000000000110000001000000001
1000000000000001101010010000000011
11000001111111111111111110000000011
11110111               101111010001
11111111               111111111111
