R 680 680
NO           textures/cowboy.xpm
SO      textures/django_unchaned.xpm
WE     textures/james_din.xpm
EA    textures/marilyn-monroe.xpm
S textures/barrel.xpm

F 255, 140, 0
C 0,    0,0


111111111111
102020102011
1000N0000111
111111111111
111111111111
1111111


