R        640     480
SO textures/mc_bg.xpm
NO textures/mc_bg.xpm
WE textures/mc_bg.xpm
EA textures/mc_bg.xpm
S textures/sprite.xpm
C 85,     85,        85
F 51,    102,    100

11111111111111111111111111111111111111111
      12200000000000000000000000000000001
      100N0100000002222222222222222222221
      12002220000002222222222222222222221
11111110000000111000000000222222222222221
10011222000000000002222222222222222222221
10011000000000000000000000000000001111111
10000000000000000000000000000000001
1111111111111111111111111111111111