C 1,1200,23
F 255,0,0
S            ./textures/SPRjgchjghITE.xpm
NO            ./textures/WALL_3.xpm
SO                                        ./textures/cyber.xpm
WE             ./textures/WALL_1.xpm
EA         ./textures/WALL_4.xpm
R 1534134354534534354534354354354                        1

1111111111111111
1000000 000000001
1W200100200111101
100000100001  101
10002000200111101
10000011110000001
102020200220202011111111111111
100002002202201000000000000001
111111111111111111111111111111