R        1920     880
SO textures/mc_bg.xpm
NO textures/mc_bg.xpm
WE textures/mc_bg.xpm
EA textures/mc_bg.xpm
S textures/sprite_mc.xpm
C 85,     85,        85
F 51,    102,    100

1111111111111111111111111111111111
1000000000000000000000000000000001
100000N000000000000000000000000001
1000000000000000000000000000000001
1000000000000000000000000000000001
1000000000000000000000000000000001
1000000000000000000000000000000001
1000000000000000000000000000000001
1000000000000000000000000000000001
1000000000000000000000000000000001
1000000000000000000000000000000001
1000000000000000000000000000000001
1000000000000000000000000000000001
1111111111111111111111111111111111