R 640 480
NO ./cowboy.xpm
SO ./django_unchaned.xpm
WE ./james_din.xpm
EA ./marilyn-monroe.xpm
S ./barrel.xpm

F 255, 140, 0
C 128,128,0

11111111111111111111111111111111111111111
      12200000000000000000000000000000001
      100N0100000002222222222222222222221
      12002220000002222222222222222222221
11111110000000111000000000222222222222221
10011222000000000002222222222222222222221
10011000000000000000000000000000001111111
10000000000000000000000000000000001
1111111111111111111111111111111111